01 01 01 01 01 01 01 01 01 01 01 01 01 01 01 01 01 01 01 06 04 01 01 01 01 01 01 01 01 01 01 01 01 01 01 01 01 01 01 01
00 00 00 00 00 00 00 00 00 00 00 00 00 00 00 00 00 00 00 02 02 00 00 00 00 00 00 00 00 00 00 00 00 00 00 00 00 00 00 00
06 00 04 01 01 06 00 04 01 01 01 01 06 00 04 01 01 06 00 02 02 00 04 01 06 00 04 01 01 01 01 01 06 00 04 01 01 06 00 04
02 00 02 00 00 02 00 02 00 00 00 00 02 00 02 00 00 02 00 02 02 00 02 00 02 00 02 00 00 00 00 00 02 00 02 00 00 02 00 02
02 00 02 00 00 02 00 02 00 04 01 01 05 00 02 00 00 02 00 02 02 00 02 00 02 00 03 01 01 01 06 00 02 00 02 00 00 02 00 02
02 00 02 00 00 02 00 02 00 02 00 00 00 00 02 00 00 02 00 03 05 00 02 00 02 00 00 00 00 00 02 00 02 00 02 00 00 02 00 02
02 00 02 00 00 02 00 02 00 02 00 04 00 04 05 00 00 02 00 00 00 00 02 00 03 01 06 00 06 00 02 00 02 00 02 00 00 02 00 02
02 00 02 00 00 02 00 02 00 02 00 02 00 03 01 01 01 05 00 04 06 00 03 01 01 01 05 00 02 00 02 00 02 00 02 00 00 02 00 02
02 00 02 00 00 02 00 02 00 02 00 02 00 00 00 00 00 00 00 02 02 00 00 00 00 00 00 00 02 00 02 00 02 00 02 00 00 02 00 02
02 00 02 00 00 02 00 02 00 02 00 02 00 04 01 01 01 01 01 05 03 01 01 01 01 01 06 00 02 00 02 00 02 00 02 00 00 02 00 02
02 00 02 00 00 02 00 03 01 05 00 02 00 03 01 01 01 01 01 01 01 01 01 01 01 01 05 00 02 00 03 01 05 00 02 00 00 02 00 02
02 00 02 00 00 02 00 00 00 00 00 02 00 00 00 00 00 00 00 00 00 00 00 00 00 00 00 00 02 00 00 00 00 00 02 00 00 02 00 02
02 00 02 00 00 02 00 04 01 06 00 02 00 04 01 01 01 01 01 01 01 01 01 01 01 01 06 00 02 00 04 01 06 00 02 00 00 02 00 02
02 00 03 01 01 05 00 02 00 02 00 02 00 02 00 00 00 00 00 00 00 00 00 00 00 00 02 00 02 00 02 00 02 00 03 01 01 05 00 02
02 00 00 00 00 00 00 02 00 02 00 02 00 02 00 00 00 00 00 00 00 00 00 00 00 00 02 00 02 00 02 00 02 00 00 00 00 00 00 02
03 01 01 01 01 05 00 03 01 05 00 02 00 02 00 00 00 00 00 00 00 00 00 00 00 00 02 00 02 00 03 01 05 00 03 01 01 01 01 05
00 00 00 00 00 00 00 00 00 00 00 02 00 02 00 00 00 00 00 00 00 00 00 00 00 00 02 00 02 00 00 00 00 00 00 00 00 00 00 00
04 01 01 01 01 06 00 04 01 06 00 02 00 03 01 01 01 01 01 01 01 01 01 01 01 01 05 00 02 00 04 01 06 00 04 01 01 01 01 06
02 00 00 00 00 00 00 02 00 02 00 02 00 00 00 00 00 00 00 00 00 00 00 00 00 00 00 00 02 00 02 00 02 00 00 00 00 00 00 02
02 00 04 01 01 06 00 02 00 02 00 02 00 04 01 01 01 01 01 01 01 01 01 01 01 01 06 00 02 00 02 00 02 00 04 01 01 06 00 02
02 00 02 00 00 02 00 03 01 05 00 03 00 03 01 01 01 01 01 06 04 01 01 01 01 01 05 00 05 00 03 01 05 00 02 00 00 02 00 02
02 00 02 00 00 02 00 00 00 00 00 00 00 00 00 00 00 00 00 02 02 00 00 00 00 00 00 00 00 00 00 00 00 00 02 00 00 02 00 02
02 00 02 00 00 02 00 04 01 06 00 04 01 01 01 01 01 06 00 02 02 00 04 01 01 01 01 01 06 00 04 01 06 00 02 00 00 02 00 02
02 00 02 00 00 02 00 02 00 02 00 02 00 00 00 00 00 02 00 02 02 00 02 00 00 00 00 00 02 00 02 00 02 00 02 00 00 02 00 02
02 00 02 00 00 02 00 02 00 02 00 02 00 00 00 00 00 02 00 03 05 00 02 00 00 00 00 00 02 00 02 00 02 00 02 00 00 02 00 02
02 00 02 00 00 02 00 02 00 02 00 03 01 01 06 00 00 02 00 00 00 00 02 00 00 00 04 01 05 00 02 00 02 00 02 00 00 02 00 02
02 00 02 00 00 02 00 02 00 02 00 00 00 00 02 00 00 02 00 04 06 00 02 00 00 00 02 00 00 00 02 00 02 00 02 00 00 02 00 02
02 00 02 00 00 02 00 02 00 03 01 01 06 00 02 00 00 02 00 02 02 00 02 00 00 00 02 00 04 01 05 00 02 00 02 00 00 02 00 02
02 00 02 00 00 02 00 02 00 00 00 00 02 00 02 00 00 02 00 02 02 00 02 00 00 00 02 00 02 00 00 00 02 00 02 00 00 02 00 02
05 00 03 01 01 05 00 03 01 01 01 01 05 00 03 01 01 05 00 02 02 00 03 01 01 01 05 00 03 01 01 01 05 00 03 01 01 05 00 03
00 00 00 00 00 00 00 00 00 00 00 00 00 00 00 00 00 00 00 02 02 00 00 00 00 00 00 00 00 00 00 00 00 00 00 00 00 00 00 00
01 01 01 01 01 01 01 01 01 01 01 01 01 01 01 01 01 01 01 05 03 01 01 01 01 01 01 01 01 01 01 01 01 01 01 01 01 01 01 01

